1agi_alphafold.pdb	AQDDYRYIHFLTQHYDAKPKGRNDEYCFNMMKNRRLTRPCKDRNTFIHGNKNDIKAICEDRNGQPYRGDLRISKSEFQITICKHKGGSSRPPCRYGATEDSRVIVVGCENGLPVHFDESFITPRH	DVQVVLLVLCCLQAEDADQDPQWQVSLLVSCVVSVCVVQPDQKGKHWYHDPVLQLCCLPPPQWDDDDDQKTKGPFWTWMKMWGFPDDGSHPPTTTGIDTDTWIWMFGDDPSGGRGTDDTDDDDDD
1bc4_alphafold.pdb	NWATFQQKHIINTPIINCNTIMDNNIYIVGGQCKRVNTFIISSATTVKAICTGVINMNVLSTTRFQLNTCTRTSITPRPCPYSSRTETNYICVKCENQYPVHFAGIGRCP	DQVLCCLQAEDQDPDDDLLVSQQDPSQQDPLFGNQKGKHFNDDSVQQLVQLVVNAWAKGKDPAWTWMKMWGQDDRDRPSGHTDIDIDTFIWIFTDHPSHGDGGQDTRDHD
1bsr_alphafold.pdb	KESAAAKFERQHMDSGNSPSSSSNYCNLMMCCRKMTQGKCKPVNTFVHESLADVKAVCSQKKVTCKNGQTNCYQSKSTMRITDCRETGSSKYPNCAYKTTQVEKHIIVACGGKPSVPVHFDASV	DDDLQNLCCLQAEDQDPDQPPDQCSLVVSCVVSVCLPPHHDFKGKHFNHDQVLQFCQQVAAFDQFPVRDRQKGKDPFWTWMWIWGFDPPADPPRTDTGIDIDTFIWIFGWDDVVTGGRGTRDTD
1rra_alphafold.pdb	AESSADKFKRQHMDTEGPSKSSPTYCNQMMKRQGMTKGSCKPVNTFVHEPLEDVQAICSQGQVTCKNGRNNCHKSSSTLRITDCRLKGSSKYPNCDYTTTDSQKHIIIACDGNPYVPVHFDASV	DQALQNLCCLFAEDQQQDPDPDQCSLVVSCVVSPCLPPWHDFKGKHFRHDQVLQFCQQVADFDQFPVRDGQKGKRPFWTWMWIWGFDPPDTPPRTHTGIDIDTFIWIFGFDDVVTGGRGTRDTD
7rsa_alphafold.pdb	KETAAAKFERQHMDSSTSAASSSNYCNQMMKSRNLTKDRCKPVNTFVHESLADVQAVCSQKNVACKNGQTNCYQSYSTMSITDCRETGSSKYPNCAYKTTQANKHIIVACEGNPYVPVHFDASV	DADLQSLCCLQAEDLVDQAQPDQCSLVVSCVVSVVLVPHNPFKGKHFNDDQVLQFCQQVAAFDQFPVRDGQKGKDPFWTWMWMWGWDPPADPPRTDTGIDIDTFIWIFGWDDVVTGGRDTRDTD
A5HAK2_DANRE_22-133_alphafold.pdb	SQSYNDFKRKHLAPAGMKEDDCTTLIVTERKIKEKNQCKKINTFILETEDKIKGVCNTPATDGKNHKGTGFTVINCTKIENIIDCKYNGVKRTTDIILTCENRLPVHYGRSN	DFDLVNCCLQAADDPPDDQQCLQCSCPPPSVDDDPPHQDQKGKYWDDDPVLVLVQLVADAPPVFKGKDFFIWMWIWGFDPPDPDTDTGIDIDGGMWIFGDDPSGGRDTDDDD
A7YWM6_BOVIN_26-150_alphafold.pdb	QLAIKNFRTLHVDYPKVTYAQGFQGYCNGLMSYVRGRQESWYCPRIHYVLHAPWTVIWKFCKYSESFCENYNEYCTLTKDSIPLTICSLYPRQPPTSCRYNSTLTNQRLYLLCSEKYDGEPIDII	DVLLVLCCLQAEAEVNDDDDCVLVDRLSVSQVVVCVVVVDLARDFKGKHFHDDQVLQLVQQQAFPDQDVVVRFGKGWDPFWTWIWMWGWDPPDDSRDTDTDIDTDTDIWMFTWHDRHSTGTRDTD
AMPS1_RANPI_5-112_alphafold.pdb	DREWEKFKTKHITSQSVADFNCNRTMNDPAYTPDGQCKPVNTFIHSTTGPVKEICRRATGRVNKSSTQQFTLTTCKNPIRCKYSQSNTTNFICITCRDNYPVHFVKTG	DVLQVLCCLAAEDCDDPVPDAQLPQQQDCSSCVVHHLDQKGKHFNDDPPLVLVQQQPPEAKDKGKRPAWTWMWMWHDDDVSHTDIDIDTFIFIFIDGRSGTRGGDDTD
AMPS2_RANPI_5-112_alphafold.pdb	DREWEKFKTKHITSQSVADFNCNRTMNDPAYTPDGQCKPINTFIHSTTGPVKEICRRATGRVNKSSTQQFTLTTCKNPIRCKYSQSNTTNFICITCRDNYPVHFVKTG	DVLQVLCCLAAEDCDDPVRDDQLVQQQDCSNVVVDHPDAKGKHFNDDVPQVLVQLVPPEAKDKGKHPAWTWMWMWHDQDVSHTDIDIDTFIFIFIDYPSGGRGTDDTD
AMPS3_RANPI_5-112_alphafold.pdb	DKEWEKFKVKHITSQSVADFNCTSTMNNPDFTPDGQCKPINTFIHSNTGPVKEICRRASGRVNKSSTQQFPLTTCKNPKRCKYSQSNETNYICITCRDNYPVHFVKIG	DVLQVLCCLQAEDCDDPVPDAQLVQQQDCSSCVVHHDDQKGKHFNDDVPQVLVQQQPDEAKDKGKRPAWTWMWMWHDDDVSHTDIDIDTFIFIFIDGRSGGRGGDDTD
AMPS4_RANPI_5-112_alphafold.pdb	DKEWVKFKAKHITSQSVADFNCNKTMNDPDFTPDGQCKPVNTFIHSNTGPVKDICRRASGRVNKSSTQQFPLTTCNKPIRCKYSQSNTTNFICITCRDNYPVHFVKIG	DVLQCLCCLQAEDCDDPVPDAQLVSQQDCSSCVVDHLDQKGKHFNDDVPLVLVQQQPPEAKDKGKRPAWTWMWMWHDDDVSHTDIDIDTAIFIFIDGRSGTRGGDDGD
B2RUF3_MOUSE_132-244_alphafold.pdb	PRFQSKQDYLKFDLSVRDCNTMMAHKIKEPNQSCINQYTFIHEDPNTVKAVCNGSLVDCDLKGGKCYKSPRPFDLTLCKLAKPGQVTPNCHYLTYITEKVIFMTCNDKKQLET	DDPDDVVNVVVVVCVVQAPLVVCVVVDDDFFDFRDQKAKDWPDDPVLVVCQVVADWDDDPPVPFTKGKRPFWTWMWMWGFPDGPDTPPPTDTDTDIDTDIDIDTDDVDDDDRD
B4DKY4_HUMAN_128-242_alphafold.pdb	SALFQSNKDYLRLDQTDRECNDMMAHKMKEPSQSCIAQYAFIHEDLNTVKAVCNSPVIACELKGGKCHKSSRPFDLTLCELSQPDQVTPNCNYLTSVIKKHIIITCNDMKRQLPT	DDDPPDPPVVVVVVVVVQAVLVVCQVVAPDFFDFDDQKDKDFPDDPVLVVCQVVADWDDDPPPPFTKGKHPFWTWMWMWGFPDGRDTPPPTDTDTDIDTGIDIDGDDPPPPPDDD
C1BKN7_OSMMO_22-148_alphafold.pdb	PGYNRFVRIHTQTRMVTQDCSRVMRRLQLNEPGTQNCKYTNTFIVTNPILEQVEAVCINAGTRDFAARDIFTSTQRFSLITCRLSSGTQHPDCVYDGTASTRRIRVSCERDLQNRRILWPTHYEGDV	DDQVVCCLQAEDEPDDQVCQLVSCQVSQDAPPPDQWRDQKGKHFHDHVDCCQVQCQQAPQWDADPVHRQKTKGPAWTKMKMWGFPDDTGPPPTDTGIDIDTFIWIFGWDADPVDRNGTGGDGTPGTD
C1C469_RANCA_23-131_alphafold.pdb	CQNRSSFKTKHIVGSRNINCKEKLKYPLFFIHGKCRAKNTFIVESEKTVLSICRKAIKKRYITSPMKVRLAICQERKNKQCIYDIVVPNNSQICVLCHKGKPIHFQKEG	DFFQVLCCLQAEDQDLPDPQLVSQPDPSQDDPNFGDQKGKHFNDDPVQQLQQLQPAAAWDKGKRPDFTWIWMWGDDDPHGSDTDIDTDPGFIFIFTHHRSGGGGGDDTD
C1C480_RANCA_23-131_alphafold.pdb	CQNWSSFKTKHIVGSRNINCKEKLKYPLFFIHGKCRAKNTFIVESEKTVLSICRKAIKKRYITSPMKVRLAICQERKNKQCIYDIVVPNNSQICVLCHKGKPIHFQKEG	DFDQVLCCLQAEDQDLPDDQLVSQPDPSQDDPNFHNQKGKHFNDDPVQQLQQQQPAAAWDKGKRPDFTWIWMWGHDDPHGSDTDIDGDDGFIWIFTHHRSHGRGTDDTD
C1C4Z5_RANCA_22-131_alphafold.pdb	SQDWATFQRKHITDKSNINCNNSMVGNLFLIRGQCKPINTFIYSTAATVQDICRGEQGPKNVASSRSFKLTDCIRTSDRGPPCPYRSDSQDNVICVTCQRTRPVHFVKKG	DQDQVLCCLQAEDCDLDDDLLVSQDDDSQDDVNFGNQKTKHFNDDQVVQLVQLVPPAAWDKGKDPAWTWMWMFGFPDRDDVVTDTDIDIDTFIFIFTDHRSHGRGTDDTD
D2HVH5_AILME_27-127_alphafold.pdb	NPSWREFMKQHYLSTSWKFSNCKCHDLMREREAPQDRNYHIFIYTFWHKIEHICLRKWRGHSRNVYIWAQQPFKILQCHQEGNGKSYREHSSYSYTEFHCG	DDDPVLCCLAAEDEPVDDPVPDDLLVNCVRSVHDPPDQKDKHFYDHSVLVVVQLVVPVVPVDAFDKGKRPFWTWMWMWGADDPRNHTDTDIDTDIDIDTGD
D2HYC5_AILME_33-156_alphafold.pdb	MTSAQWFEIQHVQPKPQRCDAAMGKVNKYTKHCKPFNTFLHQSFSSVAATCQTPTVACKRGRRNCHQSKKPVSLSTCELTSRKYPGCKYKEKRQVASYIVACDPPEKGDSRKFKLVPVHVDKTL	DDLQVLCCLFAEDLPDDDPQVSCLSVCVVVVWRDQKGKHFNDDQVLVLVQQPAQFDAFPVRDGQKGKRPAWGKMKMWGWPDGDPPPTDTDIDIDTWIWMFGWDADDVPDDPPHRTGGRGTRDTD
D2HYC6_AILME_26-149_alphafold.pdb	QIAIKNFRMLHVDYPRVNYPEGFQGYCNGLMAYVRGRKQSWFCPQIHYTVHAPWGEIKRFCLYSDSFCENYDEYCTVTEDSFPVTICSLASGQPPVSCHYNDTLTNQRLYLLCSGKHDAEPIGI	DVLQVLCCLQAEDEPQDDDDCVLVDRLSVSQVVVCVVVVDLFRDFKGKHFHDDQVVQFVQQQAFPDQDPVVRFGKDKDPFWTWMWMWGFDPDDDRNDTDTDTDTDTDIDIFTWHDGHRTGTRGD
D2I2U4_AILME_56-180_alphafold.pdb	TKDAFQQRTIIDPTRPLTDPEYCTAEMKMKNVHNKFRCVREHFFLQVAYEELQKLCKNIFVPCKNGVKKCHRSRQLIEGVYCNLTRGVRMSDCEYESSYRQGYVLITCRWQNDIQEIIPAYVNDI	DLVLCCLLAEDDVPDDLPPFQVQLVSCQVSVPADVQFDDQKAKHWHDDQVQQQVQQVADWDAFPVRPDTWGWHPAKTKIWMWGFPDDTGPPPTDTGIDIDIDTWTFDWDQDDVVRGIGTDGTRDD
D2I2U5_AILME_102-212_alphafold.pdb	LHSHKDYLRSDLMTRECNTLMAQKLKEHNRTCISQYTFIHEDVDTVKAVCNSPVVACELKGGKCHKSSRPFDLTLCRLSKPGQVTPHCNYLTFIFERRIIISCPDMKVQIM	DVPPVVVVVVVVVVQAQLVVCQVVQPDFFDFRDQKDKDWPDDPVLLLCQVVADFDDDPDPDAGKGKDPFWTKMWMWGFPDGPDTPPPTDTDIDIDTFMWIADNVVRDIDTD
D2I8F8_AILME_24-143_alphafold.pdb	SASVQTFILRHLRAGPLQCNDAMRLVNLSNRTCMRQNTFLHDTFRNVADTCGWPNRICRNGQDKCHLSANRINMTHCYHTGGRYPNCSYRTIPRQGLYTVACDPRQPGFDANCLFPVELD	DQAQVLCCLFAEDQDDDDQLVSCLSNCVVPQWRDQKGKHFNDDQVLVLVQQVAQWDQDPVRDRQKGKRPAKGKMWMWGFDDDIPPRTDTDTDIDTGMWMFGWDLDHPPDHSPGTGGRDTD
D4ABQ0_RAT_24-136_alphafold.pdb	STSRRQFMEQHHLSSNEEFSAYSCDVLMTEKALRPRLSHPFVYMTWYKVEHICISSNWKDRYKNLYVWAQTPIKVLRCQWENLKSRYTEKRSYSYVQFHCNADGYVDSIEDMK	DVLQVLCCLAAEDEPVDDPVPDDLQVSCVNSVVPPDQKGKHWYDHSVVQFCQLVDPPPVSQQAWDKGKDPFWTWMWMWGQDPVVRGTDTDTDGWTWIFIAHRNSHTRDTDDID
EP3B_HUMAN_27-141_alphafold.pdb	EVSWREFMKQHYLSPSREFREYKCDVLMRENEALKDKSSHMFIYISWYKIEHICTSDNWMDRFRNAYVWVQNPLKVLKCHQENSKNSYTESRSFNYIEFHCSMDGYVDSIEDLKM	DDDLVVQCLAAEDEPVDDPVVDFLLCNCPVRPVNPPPQKDKHWYDHPVVQQCQQADVPNVDGNAQDKGKDPFWTWMWMWGHDPPDSGIDIDIDTWTWIFGQHRVRHTDDTDDTDD
Q12762_HUMAN_20-159_alphafold.pdb	LWRAHSMSNLHSLPGLRGLTSISRNQLQCTNAMRVINNYQRRWKNRNTFLLATFANVVNVCGNPTITCPHNRTLNNCHHSGVQVPLMYCNLTTPSPQNISNCRYAQTPANMFYIVACDNRDQRRDPPQYPVVPVHLHTII	DQQCLQAQALCPDPQSVVVVDQDLPRPFLLSSQLVVCVVVVHHDQKHKYFPDHQVLQLVQQVADWDQQPPHNVDGQKGKSVFWTKMKMWGWDDDDNPDSSPTHTDIDIDTWIWMFGKDQDDPVPDDPVRRIGTRHGRDTD
Q3KNL9_MOUSE_63-180_alphafold.pdb	EMITIGDQPFNDYDYCNTELRTKQIHYKGRCYPEHYIAGVPYGELVKACDGEEVQCKNGVKSCRRSMNLIEGVRCVLETGQQMTNCTYKTILMIGYPVVSCQWDEETKIFIPNHIYNM	DAAEDDPDDLPDFQRLLVRCQVVVDDDVQWDDQKAKYWPDDQVLVFQQQVADWDDFPDPDRIWGWAPDWTKIWMWGFDDDTGPPPTDTGTDIDIDTFTFDWDQDPPVRGTGGDGTRDD
Q5QJV4_RAT_61-177_alphafold.pdb	EMITVGERPLQDYDYCNSELRAKQIHDKGRCYPERYIVGMSYEELSKACYGQRVQCKNGVKFCRRSMDLTDGVRCVLESGERMVDCMYTTIYMTGYPVVTCQWDKESQEFIPNYIHN	DDAAEDPDDLPDQQRLLVRCQVVVPADVQFDDQKAKYWPDDQVLVLVQVVADWDDDPDPDRIWGWAPDKTKIWMWGFPDDTGPPPTDTGTDIDIDTWIFDWDQDPVVRGTGTDGTPD
Q6EUW8_RANCA_23-125_alphafold.pdb	CQNWETFQKKHLTNILDINCDVEMAKALFNCKEMNTFIYALPGRVQALCKNIRDNTDVLSRDAFLLPQCDRIKLPCHYKLSSSTNTICITCVNQLPIHFAGVG	DQFQVLCCLQAEDCDQPDPQLVSCVDPSNQQPQKGKHFNDDSVVVLVQLPPPADFDKGKDPAWTKIWMWGAPDPPRDTDIDIDTFIWIFTDHHSGTRGGPGTD
Q8K0E4_MOUSE_32-141_alphafold.pdb	TSRRQFMEHHHLSPNKMFSDYNCDVLMTDKAVKPKLSHMFVYMTWYKVEHICIGSNWRDRYKNMYIWAQTPIKVLRCQWESLKNRYTERRSYSYVQFHCNADGYVDSIED	DLQVLCCLQAEDEPVDPPVVDDQQVNCVNSVVPPDQKDKHWYDHPVVQFCQQQDPPNVDGNAQDKDKDPFWTWMWMWGQDPVVRGTDTDIDTDIKIFGQHRVRHTRDIDD
Q8MI70_PIG_27-139_alphafold.pdb	NLSWREFMKQHHLNTNWEFSKYRCNDLMRERDIPKDKNNHLFVYTLWQKIERMCIRNWRDRYRNVYIWGQYPFKTLKCYRKNNKSNYKDYKSYSYIEFHCSKNGYVDSIEDMR	DAPLVLCCLQAEDEPPDPPVPDDPLVNCVNSVPDLPPQKDKHFYDDSVLQFCQQPPDPVGGNEQDKDKDPFWTWMWMWGDDPPDSGTDTDTDTWIWIFGQHRVRHTDDTDDID
Q9DF78_RANCA_21-130_alphafold.pdb	SQNWAKFKEKHITSTSSIDCNTIMDKAIYIVGGKCKERNTFIISSEDNVKAICSGVSPDRKELSTTSFKLNTCIRDSITPRPCPYHPSPDNNKICVKCEKQLPVHFVGIG	DFDQVLCCLQAEDQDPDDDLLVSQQDPSQDDPNWGNFKGKHFNDDSVVQLVQLVPDPDWDKGKDPAWTWMKMWGFPDTDDPSTDTDIDIDTFIWIFTDHPSGGRGTDDTD
Q9DFY6_RANCA_23-126_alphafold.pdb	CQDWATFKKKHLTDTWDVDCDNLMPTSLFDCKDKNTFIYSLPGPVKALCRGVIFSADVLSNSEFYLAECNVKPRKPCKYKLKKSSNRICIRCEHELPVHFAGVG	DQFQVLCCVQAEDCDLPDPLLVPCVDPSNVLDQKGKHFNDDQPLVLQQLVPPAAWDKGKDPAWTWIWMWGFDDVVVTDTDTDIDTFIFIFIHHRSGTRGGPGTD
Q9DFY8_RANCA_23-125_alphafold.pdb	CQNWETFQKKHLTDTRDVKCDAEMKKALFDCKQKNTFIYARPGRVQALCKNIIVSKNVLSTDEFYLSDCNRIKLPCHYKLKKSSNTICITCENKLPVHFVAVE	DQDQVLCCLQAEDCDLDDPQLVSCVDPSNQLPQKGKHWNDDSVVQLQQLQPPAAWDKGKDPAWTWMWMWGDPDPPRDTDTDIDTFIFIFIHHRSHTRGTDDTD
Q9I8V8_RANPI_23-125_alphafold.pdb	CQDWLTFQKKHLTNTRDVDCNNIMSTNLFHCKDKNTFIYSRPEPVKAICKGIIASKNVLTTSEFYLSDCNVTSRPCKYKLKKSTNTFCVTCENQAPVHFVGVG	DQDQVLCCLQAEDCDLPDPQLVSCVDPSNVQDFKGKHFNDDSPVQLQQLPPPADWDKGKDPAWTWIWMWGDDPDGSHTDIDIDTFIFIFTHHRSGGRGGDGTD
Q9R124_MOUSE_28-156_alphafold.pdb	QTPSQWFAIQYINNNANLQCNVEMLRINRSRRTCKGLNTFLHTSFANAVGVCGNPSGLCSDNISQNCHNSSSRVHITVCNITSWRRTPYTQCRYQAKRSLEYYTVACDPRTPQDSPMYPVVPVHLDGTF	DDLQVVCCLQAEDQDPPDDLLVSQLSVCVVVQFRDAKGKHFNDDQVLQLVQQPAQWQAFPVNPDRQKGKRPAWTKMWMWGWPDDRPPGSNPTHTDIDIDTWIWMFRKDQDDPPDDPVRRIGTRDTRDTD
Q9W738_XENLA_27-140_alphafold.pdb	TQNINAFMEKHIVKEGAETNCNQTIKDRNIRFKNNCKFRNTFIHDTNGKKVKEMCAGIVKSTFVISKELLPLTDCLLMGRTARPPNCAYNQTRTTGVINITCENNYPVHFAGYK	DFDQVVCCLQAEDAAPDDDDLLVSCLVSVPPDPQFRDQKTKHWHDHVCVQQLVQLPPPAAWDKTKDPDWTWMKIWGFPDPPHGPPPTDTDIDIDTFIWIFIHHRSHTGGTPGTD
RNAS9_CEBAL_62-184_alphafold.pdb	EKVKRRILVNPGMPLGDSGYCNYQIMRKNVYYKYSCVTEHYFLLMQYDELQKTCYNRFVPCKNGIRKCNMSKKLVEGVYCNLTKASNIPLCQYNSFYRRGYVLITCTWQNEMQKLIPYPINDL	DLCCLFAEDDPPDDLPDFCVCLVSCVVSVVDDPFWDDQKGKHWHDDQVQQQVQQVADWDQDPVNPDIWGKRPAKIKIWMWGFDDDTGPPTTDTTIDIDIGIDTFDWDQDPVVRGTHTDPPPPD
RNAS9_CEBCA_62-185_alphafold.pdb	EKVKRRILVNPGMPLGDSGYCNYQIMRKNVYYKYSCVTEHYFLLMQYDELQKTCYNRFVPCKNGIRKCNMSKKLVEGVYCNLTKASNIPLCQYNSFYRRGYVLITCTWQNEMQKLIPYTINDLV	DLCCLLAEDDPPDDLPDFCVCLVSCVVSVVDDPWWDDQKAKHWHDDQVQQQVQQVADWDQFPVRPDIWGKRPAKIKIWIWGWDDDTGPPPTDTTIDIDIAIWTFDWDQDPVVRGTHTDGTRDGD
RNAS9_HYLSY_62-184_alphafold.pdb	EKVKRRVLIEPGMPLNHIEYCNHEIMGKNVYYKHRCVAEHYFLLMQYDELQNICYNRFVPCKNGIRKCNRSKGLVEGVYCNLTEAFEIPACKYESFYRKGYVLITCAWQNELQKLIPHTINDL	DLCCLLAEDDPDDDLPDFCPCLVSCVVSVVDDPQWDDQKDKHWHDDQVQQQVQQVADWDQFPVRPDTWGKHPAKTKIWMWGFDDDTGPPPTDTGIDIDIGIWTFDWDQDPVVRGTHTDGTRDD
RNAS9_MACNE_61-184_alphafold.pdb	KEKVERRVIIEPGMPLYHRDYCNEEIMRKNVYHKQRCVTEHYFLLMQYDELEKICYNRFVPCKNGVRKCNRSKGLVEGVYCNLTEAFKIPRCKYKSFYRRGYVLITCAWQNEIHKLIPHTINDL	DVLCCLQAEDDPDDDLPDFCCVLVSCVVSVVDDPQWDDQKGKHWHDDQVLVQVQQVADWDQFPVRPDTWGKHPAKTKIWMWGFDDDTGPDPTDTTIDIDIGIWTFDWDQDPVVRGTHTDGGRDD
RNAS9_MOUSE_63-180_alphafold.pdb	EMITIGDQPFNDYDYCNTELRTKQIHYKGRCYPEHYIAGVPYGELVKACDGEEVQCKNGVKSCRRSMNLIEGVRCVLETGQQMTNCTYKTILMIGYPVVSCQWDEETKIFIPDHIYNM	DAAEDDPDDLPDFQRLLVRCLVVVPDDVQWDDQKAKYWPDDQVLVFVQQVADWDDFPPPDRIWGWAPDKTKIWMWGFPDDTGSVDTDTGTDIDIDTFTFDWDQDPPVRGTGGDGTRDD
RNAS9_SAIBB_64-187_alphafold.pdb	EKVKRRILVNPGMPLGDSGYCNYQIMRKNVYYKYSCVTEHYFLLMQYDELEKTCYNRFVPCKNGIRKCNRSKKLVEGVYCYLTEASNLPMCQYESFYRRGYVLITCTWQNEIQKLIPYTINDIV	DLCCLQAEDEPPDPLVDFCVCLVNCQVSVVDDPQWRDQKAKHWHDDQVQQQVQLVADWDQFPVSPDIWGKRPAKTKIWMWGFPDIDGPPRTDTTIDIAIAIWTFDWDQDPVVRGTHTDGTRDGD
RNASL_RANCA_1-109_alphafold.pdb	QNWAKFKEKHIRSTSSIDCNTIMDKAIYIVGGKCKERNTFIISSEDNVKAICSGVSPDRKELSTTSFKLNTCIRDSITPRPCPYHPSPDNNKICVKCEKQLPVHFVGIG	DDQVLCCLQAEDQDPPDDLLVSQQDPSQDDPNWGNQKGKHFNDDQVVQLVQLPPPPQWDKGKDPAWTWMWMWGFPDTDDPSTDTDIDIDTFIWIFIHHPSHGDGTDDGD
RNS10_BOVIN_98-161_alphafold.pdb	VLLHSNKDYLRSDVMDRECNALMALKVKSKDHTCIPQYIFIHEELDAVKAVCKSPAVACDLKGG	DDPPDLPVLPPPDPDVVNVVVVQVVVPDPDPPDRDPDDDDDSDDPVVVVVVVVDDDDDDPPPDD
RNS10_HORSE_103-164_alphafold.pdb	FQSDKDYLRLDLMNRECNSLMAHKVKKRNHTCIPEYTFIHEELDTVKAVCKNPVVACDLKGA	DPDVVVVVVVVVVVVVVVVVCVVVQDPPDRDDDPDDDDDPDDPVVVVVCVPDDDDDDPDPDD
RNS10_HUMAN_100-214_alphafold.pdb	SALFQSNKDYLRLDQTDRECNDMMAHKMKEPSQSCIAQYAFIHEDLNTVKAVCNSPVIACELKGGKCHKSSRPFDLTLCELSQPDQVTPNCNYLTSVIKKHIIITCNDMKRQLPT	DDDPPDPPVVVVVVVVVLAVLVVCVVVAPDFFDFDDQKDKDFPDDPVLVVCQVVADWDDDPPPPFTKGKHPFWTWMWMWGFPDGRDTPPPTHTDTDIDTGIDIDGDDPPPPPDDD
RNS10_MOUSE_95-206_alphafold.pdb	PRFQSKQDYLKFDLSVRDCNTMMAHKIKEPNQSCINQYTFIHEDPNTVKAVCNGSLVDCDLQGGKCYKSPRPFDLTLCKLAKPGQVTPNCHYLTYITEKSIFMTCNDKRQLE	DDPDDVVNVVVVVCVVQAPLVVCVVVDDDFFDFRDQKDKDWPDDPVLVVCQQVADFDDDPPPPFTKGKRPFWTWMWMWGFPDGPDTPPPTDTDTDIDTGIDIFGDDPPDDDD
RNS10_PIG_94-211_alphafold.pdb	LRAQAFSQSYPNYLRSDLMDRECNTLMAKKMKPYNHTCISQYIFIHEEPDEIKAVCKSPPVACELKGGKCHKSARPFDLTFCKLSKPGQVTPHCNYVTFLLEKHILISCNDMKVQVMS	DDDDPPPPPPPDDDPVVCVVLFVLVVCQVVDDDFFDFGDQKDKDWPDDPVLLLCQVVADFDDDPDPDDTKGKRPFWTWMWMWGFPDGPDTPPPTDTDTDIDTFMWIADNVVRDIDTDD
RNS10_RAT_98-211_alphafold.pdb	KTLLQSKQGYLKFDLNIRDCNVMMAHKIKEHNQSCINDYTFIHEDPSTVGAVCNSPLVDCDLKGGKCHKSPRPFDLTLCKLAKPGQVTPNCHYLTYITEKVIIITCNNTKQLEI	DPPVVVVVVVVVVVCVVQAPLVVCLVVDDDFFDWDDQKDKDWPDDPVLVVCQVVAQFDDDPPVVFRKGKRPFWTKMWMWGFPDGPDTPPPTHTDIDIDTDIDIWGDDPPDDTDD
RNS10_SHEEP_95-161_alphafold.pdb	AEVLSQSNKHYLRSDVMDRECNALMAPNLKSKDHPCIPQYVFIHEEPDTVKAVCKSPAVACDLKEGK	DDDDPPVLVQLVCPDDDVVNVVVVCPVVCPDPVPNDDPDDDDHSDDPVVVVVVVVDDDDDDPPPDPD
RNS11_HUMAN_72-187_alphafold.pdb	SSTLLTFRSLHYNDPKGNSSGNDKECCNDMTVWRKVSEANGSCKWSNNFIRSSTEVMRRVHRAPSCKFVQNPGISCCESLELENTVCQFTTGKQFPRCQYHSVTSLEKILTVLTGH	DDDPVNVCVQAEDEPPPPPPDDLQVVLLVVCQVVVDDDPVQWDDQKGKHWYDDPVQVVPWAFDPPPPPPPDDFKGKTKTAWTKMWMWGWDDDTGPSPTGTDIDIDTDMDIDIGGDD
RNS12_HUMAN_21-146_alphafold.pdb	EAVMSTLEHLHVDYPQNDVPVPARYCNHMIIQRVIREPDHTCKKEHVFIHERPRKINGICISPKKVACQNLSAIFCFQSETKFKMTVCQLIEGTRYPACRYHYSPTEGFVLVTCDDLRPDSFLGYV	DPPPQFCCLFAEAECNDPDVDLQCSLLVSCVVSVDADPVQWRDQKGKHWHDDQVQQLCQLVAPDWDQDVPHRVFIKGKRPAKTWMWMWGFDDGTGPPPTHTGTDIDIFIWIAGDDPSGGGDTDDGD
RNS13_HUMAN_29-151_alphafold.pdb	SRNFYTLSIDYPRVNYPKGFRGYCNGLMSYMRGKMQNSDCPKIHYVIHAPWKAIQKFCKYSDSFCENYNEYCTLTQDSLPITVCSLSHQQPPTSCYYNSTLTNQKLYLLCSRKYEADPIGIAG	DVVCCVLAEDECNDDDDPPPQCPLLVSQVVVCVVVVPPFRDFKDKHFHDDQVVQLVQQQAFPDQDPVVRFTKHKDPFWTWMWMWGFDPPDDGPGTGTDTDIDTDIWIFGWHDRHSTHTDGTDD
RNS13_RAT_26-150_alphafold.pdb	QTAIKNFRILHVDYPMVNYPKGFHGYCNGLMAYVRGKLQDWYCPKIHYVVHAPFESIQKFCKYSESFCEDYNEYCTLTQNSFPITVCTLDHKQAPTSCSYNSTLTNQRLYLLCSRKHDAEPIGVI	DVLLVLCCLQAEAEVNDDDDCVLVDRLSVNQVVVCVVVVDLARDQKGKHFHDDQVVVFVQLQAFPAADPVVRFTKDKDPFWTWMWMWGWDDDDDSNDTDTDTDTDTDIWIFTWHDRHSTGTRGTD
